9999999999999999999999999999999999999999999999999999999999
9999999999999999999999999999999999999999999999999999999999
9999999999999999999999999999999999999999999999999999999999
9999999999999999999999999999999999999999999999999999999999
9999999999188888888888888888888888888882999999999999999999
9999999999600000000000000000000000000005999999999999999999
9999999918b0000000000000000000000000000a829999999999999999
99999999600////////////////////////////0059999999999999999
99999918b00////////////////////////////00a8299999999999999
999999600///////////////////////lll//////00599999999999999
999991b00////////////////////////ll//////00a29999999999999
9999960////ll//////////////////////////////059999999999999
9999960////ll//////////////////////////////059999999999999
999996////////////////ll////////////////////59999999999999
999996/////d777777c///ll///////d777777c/////59999999999999
999996/////59999996///lll//////59999996/////59999999999999
999996/////59999996///lll//////59999996/////59999999999999
999996/////59999996////////////59999996/////59999999999999
999996/////59999996////////////59999996/////59999999999999
999996/////59999996////////////59999996/////59999999999999
999996/////a888888b////////////a888888b/////59999999999999
999996/////00000000////////////00000000/////59999999999999
999996/////00000000////////////00000000/////59999999999999
999996//////////////////////////////////////59999999999999
999996//////////////////////////////////////59999999999999
999996//////////l///////////////llllll//////59999999999999
999996//////////l///////////////llllll//////59999999999999
999996//////////llll////////////llllll//////59999999999999
999996//////////llll////////////////ll//////59999999999999
999996//////////////////////////////ll//////59999999999999
999996//////////////////////////////ll//////59999999999999
999996///////////////d777777c///////////////59999999999999
999996///////////////59999996///////////////59999999999999
999996//////l////////59999996///////////////59999999999999
999996//////l////////59999996///////////////59999999999999
999996//////ll///////59999996///////////////59999999999999
999996//////ll///////59999996///////////////59999999999999
999996//////ll///////a888888b///////////////59999999999999
999996///////////////00000000///////////////59999999999999
999993c//////////////00000000//ll//////////d49999999999999
9999996////////////////////////ll//////////599999999999999
99999937c//////////////////////ll////////d7499999999999999
999999996//////////////////////ll////////59999999999999999
9999999937c////////////////////////////d749999999999999999
99999999996////////////////////////////5999999999999999999
9999999999377777777777777777777777777774999999999999999999
9999999999999999999999999999999999999999999999999999999999
9999999999999999999999999999999999999999999999999999999999
9999999999999999999999999999999999999999999999999999999999
9999999999999999999999999999999999999999999999999999999999
