99999999999999999999999999999999999999999999999999999999999999
99999999999999999999999999999999999999999999999999999999999999
99999999999999999999999999999999999999999999999999999999999999
99999999999999999999999999999999999999999999999999999999999999
99999999999999999999999999999999999999999999999999999999999999
99999999999999999999999999999999999999999999999999999999999999
99999999999999999999999999999999999999999999999999999999999999
99999999999999999999999999999999999999999999999999999999999999
99999999999999999999999999999999999999999999999999999999999999
99999999999991888299999999999999999999999999999999999999999999
99999999999996000599999999999999999999999999999999999999999999
99999999999996000a88829999999999999999999999999999999999999999
99999999999996///000059999999999999999999999999999999999999999
99999999999996///000059999999999999999999999999999999999999999
99999999999996///////59999999991888829999999999999999999999999
99999999999996///////59999999996000059999999999999999999999999
9999999999991b///////59999999996000059999999999999999999999999
99999999999960///////59991882996////59918829999918888888888882
99999999999960///////59996005996////59960059999960000000000005
9999999999996////////a888b00a88b////a88b00a88888b0000000000005
9999999999996////////00000//0000////0000//0000000////////////5
9999999999996////////00000//0000////0000//0000000////////////5
9999999999996//////////////////////////////////////d7777c//d74
9999999999996//////////////////////////////////////599996//599
9999999999993777777777777c/////////////////////////599996//599
99999999999999999999999996/////////////////////////599996//599
99999999999999999999999996//dc///////d7777777777777499996//599
9999999999991888888888888b//56///////51888888888888299996//599
99999999999960000000000000//56///////56000000000000a8888b//599
99999999999960000000000000//56///////56000000000000000000//599
9999999999996///////////////56///////56////////////000000//599
9999999999996///////////////56///////56///M////////////////599
9999999999996///////////////56///////56////////////////////599
9999999999996///////////////56///////56////////////lll/////599
9999999999996///////////////56///////56////////////l///////599
9999999999996///////////////56///////56//////////////////d7499
9999999999996///////////////56///////56////l/ll//////////59999
9999999999996///////////////56///////56//lll///////////d749999
9999999999996///////////////56///////56////////////////5999999
9999999999996///////////////56///////5377777777777777774999999
9999999999996///////////////56///////5999999999999999999999999
999999999999377777777777777746///////a888888888888888882999999
999999999999999999999999999996///////0000000000000000005999999
999999999999999999999999999996///////0000000000000000005999999
99999999999999188888888888888b/////////////////////////5999999
999999999999996000000000000000/////////////////////////a829999
999999999999996000000000000000/////////////////////////0059999
999999999999996////////////////////////////////////////0059999
999999999999996//////////////////////////////////////////59999
999999999999996//////////////////////////////////////////59999
99999999999999377777777777777777777777c////d777777777777749999
999999999999999999999999999999999999996////5999999999999999999
999999999999999999999999999999999999996////5999999999999999999
999999999999999999999999999999999999996////5999999999999999999
99999999999999999999999999999999999999377774999999999999999999