99999999999999999999999999999999999999999999999999
99999999999999999999999999999999999999999999999999
99999999999999999999999999999999999999999999999999
99999999999999999999999999999999999999999999999999
99999999991888888888888888888888888888829999999999
99999999996000000000000000000000000000059999999999
9999999918b0000000000000000000000000000a8299999999
99999999600////////////////////////////00599999999
99999918b00////////////////////////////00a82999999
999999600///////////////////////lll//////005999999
999991b00////////////////////////ll//////00a299999
9999960////ll//////////////////////////////0599999
9999960////ll//////////////////////////////0599999
999996////////////////ll////////////////////599999
999996/////d777777c///ll///////d777777c/////599999
999996/////59999996///lll//////59999996/////599999
999996/////59999996///lll//////59999996/////599999
999996/////59999996////////////59999996/////599999
999996/////59999996////////////59999996/////599999
999996/////59999996////////////59999996/////599999
999996/////a888888b////////////a888888b/////599999
999996/////00000000////////////00000000/////599999
999996/////00000000////////////00000000/////599999
999996//////////////////////////////////////599999
999996//////////////////////////////////////599999
999996//////////l///////////////llllll//////599999
999996//////////l///////////////llllll//////599999
999996//////////llll////////////llllll//////599999
999996//////////llll////////////////ll//////599999
999996//////////////////////////////ll//////599999
999996//////////////////////////////ll//////599999
999996///////////////d777777c///////////////599999
999996///////////////59999996///////////////599999
999996//////l////////59999996///////////////599999
999996//////l////////59999996///////////////599999
999996//////ll///////59999996///////////////599999
999996//////ll///////59999996///////////////599999
999996//////ll///////a888888b///////////////599999
999996///////////////00000000///////////////599999
999993c//////////////00000000//ll//////////d499999
9999996////////////////////////ll//////////5999999
99999937c//////////////////////ll////////d74999999
999999996//////////////////////ll////////599999999
9999999937c////////////////////////////d7499999999
99999999996////////////////////////////59999999999
99999999993777777777777777777777777777749999999999
99999999999999999999999999999999999999999999999999
99999999999999999999999999999999999999999999999999
99999999999999999999999999999999999999999999999999
99999999999999999999999999999999999999999999999999
