TTTTTTTTTTTTTTTTTTTTTTTTTTTTTTTTTTTTTTTTTTTTTTTTTTTTTTTTTTTTTTTTTT
TTTTTTTTTTTTTTTTTTTTTTTTTTTTTTTTTTTTTTTTTTTTTTTTTTTTTTTTTTTTTTTTTT
TTTTTTTTTTTTTTTTTTTTTTTTTTTTTTTTTTTTTTTTTTTTTTTTTTTTTTTTTTTTTTTTTT
TTTTTTTTTTTTTTTTTTTTTTTTTTTTTTTTTTTTTTTTTTTTTTTTTTTTTTTTTTTTTTTTTT
TTTTTTTTTTTTTTTTTTTTTTTTTTTTTTTTTTTTTTTTTTTTTTTTTTTTTTTTTTTTTTTTTT
TTTTTTTTTTTTTTTTTTTTTTTTTTTTTTTTTTTTTTTTTTTTTTTTTTTTTTTTTTTTTTTTTT
TTTTTTTTTTTTTTTTTTTTTTTTTTTTTTTTTTTTTTTTTTTTTTTTTTTTTTTTTTTTTTTTTT
TTTTTTTTTTTTTTTTTTTTTTTTTTTTTTTTTTTTTTTTTTTTTTTTTTTTTTTTTTTTTTTTTT
TTTTTTTTTTTTTTTTTTTTTTTTTTTTTTTTTTTTTTTTTTTTTTTTTTTTTTTTTTTTTTTTTT
TTTTTTTTTTTTTTTTTTTTTTTTTTTT       TTTTTTTTTTTTTTTTTTTTTTTTTTTTTTT
TTTTTTTTTTTTTTTTTTTTTTTTTTTT       TTTTTTTTTTTTTTTTTTTTTTTTTTTTTTT
TTTTTTTTTTTTTTTTTTTTTTTTTTTT       TTTTTTTTTTTTTTTTTTTTTTTTTTTTTTT
TTTTTTTTTTTTTTTTTTTTTTTTTTTT       TTTTTTTTTTTTTTTTTTTTTTTTTTTTTTT
TTTTTTTTTTTTTTTTRRRRRTTTTTTTT     TTTTTTTTTTTTTTTTTTTTTTTTTTTTTTTT
TTTTTTTTTTTTTTTTR   RTTTTTTT       TTTTTT        TTTTTTTTTTTTTTTTT
TTTTTTTTTTTTTTTTR L RTTTTTTTT     TTTTTTTT        TTTTTTTTTTTTTTTT
TTTTTTTTTTTTTTTTR   RTTTTTTTTT   TTTTTTTTT        TTTTTTTTTTTTTTTT
TTTTTTTTTTTTTTTTR   RTTTTTTTTTT TTTTTTTTTT        TTTTTTTTTTTTTTTT
TTTTTTTTTTTTTTTTRR RRTTTTTTTTTT TTTTTTTTTT        TTTTTTTTTTTTTTTT
TTTTTTTTTTTTTTTTTT TTTTTTTTTTTT TTTTTTTTTTT      TTTTTTTTTTTTTTTTT
TTTTTTTTTTTTTTTTTT TTTTTTTTTTTT TTTTTTTTTTTTTT TTTTTTTTTTTTTTTTTTT
TTTTTTTTTTTTTTTTTT TTTTTTTTTTTT TTTTTTTTTTTTTT TTTTTTTTTTTTTTTTTTT
TTTTTTTTTTTTTTTTTT TTTTTTTTTTTT TTTTTTTTTTTTTT TTTTTTTTTTTTTTTTTTT
TTTTTTTTTTTTTTTT   TTTTTTTTTTTT TTTTTTTTTTTTTT TTTTTTTTTTTTTTTTTTT
TTTTTTTTTTTTTTTT TTTTTTTTTTTTTT TTTTTTTTTTTTTT TTTTTTTTTTTTTTTTTTT
TTTTTTTTTTTTTTTT TTTTTTTTTTTTT   TTTTTTTTTTT   TTTTTTTTTTTTTTTTTTT
TTTTTTTTTTTTTTTT TTTTTTTTTTTT     TTTTTTTTTT TTTTTTTTTTTTTTTTTTTTT
TTTTTTTTTTTTTTTT TTTTTTTTTTT       TTTTTTTT  TTTTTTTTTTTTTTTTTTTTT
TTTTTTTTTTTTTTTT TTT                         TTTTTTTTTTTTTTTTTTTTT
TTTTTTTTTTTTTTTT TTT TTTTTTT       TTTTTTTTT TTTTTTTTTTTTTTTTTTTTT
TTTTTTTTTTTTTTTT TTT TTTTTTTT     TTTTTTTTTT TTTTTTTTTTTTTTTTTTTTT
TTTTTTTTTTTTTTTT TTT TTTTTTTTT   TTTTTTTTTTT TTTTTTTTTTTTTTTTTTTTT
TTTTTTTTTTTTTTTT TTT   TTTTTTTT TTTTTTTTTTTT TTTTTTTTTTTTTTTTTTTTT
TTTTTTTTTTTTTTTT TTTTT TTTTTTTT TTTTTTTTTTTT TTTTTTTTTTTTTTTTTTTTT
TTTTTTTTTTTTTTTT TTTTT TTTTTTTT TTT TTTTTTT  TTTTTTTTTTTTTTTTTTTTT
TTTTTTTTTTTTTTTT TTTTT TTTTTTTT TTTTTT TTTTT TTTTTTTTTTTTTTTTTTTTT
TTTTTTTTTTTTTTTT       TTTTTTTT TTTTTT TTTTT TTTTTTTTTTTTTTTTTTTTT
TTTTTTTTTTTTTTTT       TTTTTTTT TTTTTTTTTTTT TTTTTTTTTTTTTTTTTTTTT
TTTTTTTTTTTTTTTT       TTTTTTTT TTTTTTTTTTT   TTTTTTTTTTTTTTTTTTTT
TTTTTTTTTTTTTTTT       TTTTTTTT TTTTTTTTTTT   TTTTTTTTTTTTTTTTTTTT
TTTTTTTTTTTTTTTT       TTTTTTTT TTTTTTTTTTT   TTTTTTTTTTTTTTTTTTTT
TTTTTTTTTTTTTTTT       TTTTTTTT TTTTTTTTTTT   TTTTTTTTTTTTTTTTTTTT
TTTTTTTTTTTTTTTTTTTTTTTTTTTTTTT TTTTTTTTTTT   TTTTTTTTTTTTTTTTTTTT
TTTTTTTTTTTTTTTTTTTTTTTTTTT        TTTTTTT     TTTTTTTTTTTTTTTTTTT
TTTTTTTTTTTTTTTTTTTTTTTTTT          TT TT      TTTTTTTTTTTTTTTTTTT
TTTTTTTTTTTTTTTTTTTTTTTTTT          TTTT       TTTTTTTTTTTTTTTTTTT
TTTTTTTTTTTTTTTTTTTTT TTTT           TTT     T TTTTTTTTTTTTTTTTTTT
TTTTTTTTTTTTTTTTTTTTTTTTTT                T    TTTTTTTTTTTTTTTTTTT
TTTTTTTTTTTTTTTTTTTTT TTTTT        TTTT        TTTTTTTTTTTTTTTTTTT
TTTTTTTTTTTTTTTTTTTTTTTTTTTT      TTTTT  T  T  TTTTTTTTTTTTTTTTTTT
TTTTTTTTTTTTTTTTTTTTTTTTTTTTTTTTTTTTTTTT      TTTTTTTTTTTTTTTTTTTT
TTTTTTTTTTTTTTTTTTTTTTTTTTTTTTTTTTTTTTTTTTTTTTTTTTTTTTTTTTTTTTTTTT
TTTTTTTTTTTTTTTTTTTTTTTTTTTTTTTTTTTTTTTTTTTTTTTTTTTTTTTTTTTTTTTTTT
TTTTTTTTTTTTTTTTTTTTTTTTTTTTTTTTTTTTTTTTTTTTTTTTTTTTTTTTTTTTTTTTTT
TTTTTTTTTTTTTTTTTTTTTTTTTTTTTTTTTTTTTTTTTTTTTTTTTTTTTTTTTTTTTTTTTT
TTTTTTTTTTTTTTTTTTTTTTTTTTTTTTTTTTTTTTTTTTTTTTTTTTTTTTTTTTTTTTTTTT
TTTTTTTTTTTTTTTTTTTTTTTTTTTTTTTTTTTTTTTTTTTTTTTTTTTTTTTTTTTTTTTTTT
TTTTTTTTTTTTTTTTTTTTTTTTTTTTTTTTTTTTTTTTTTTTTTTTTTTTTTTTTTTTTTTTTT
TTTTTTTTTTTTTTTTTTTTTTTTTTTTTTTTTTTTTTTTTTTTTTTTTTTTTTTTTTTTTTTTTT